name,rationale,field,year_birth,year_prize,year_research_mid,year_death,TheoryOrTheoryAndEmpirical,age_highdegree,Age of discovery,delay
Jacobus Henricus van 't Hoff,"""in recognition of the extraordinary services he has rendered by the discovery of the laws of chemical dynamics and osmotic pressure in solutions""",Chemistry,1852,1901,1885,1911,1,22,33,16
Hermann Emil Fischer,"""in recognition of the extraordinary services he has rendered by his work on sugar and purine syntheses""",Chemistry,1852,1902,1895,1919,0,22,43,7
Svante August Arrhenius,"""in recognition of the extraordinary services he has rendered to the advancement of chemistry by his electrolytic theory of dissociation""",Chemistry,1859,1903,1884,1927,1,25,25,19
Sir William Ramsay,"""in recognition of his services in the discovery of the inert gaseous elements in air, and his determination of their place in the periodic system""",Chemistry,1852,1904,1894,1916,0,20,42,10
Johann Friedrich Wilhelm Adolf von Baeyer,"""in recognition of his services in the advancement of organic chemistry and the chemical industry, through his work on organic dyes and hydroaromatic compounds""",Chemistry,1835,1905,1873,1917,0,23,38,32
Henri Moissan,"""in recognition of the great services rendered by him in his investigation and isolation of the element fluorine, and for the adoption in the service of science of the electric furnace called after him""",Chemistry,1852,1906,1898,1907,0,28,46,8
Eduard Buchner,"""for his biochemical researches and his discovery of cell-free fermentation""",Chemistry,1860,1907,1897,1917,0,28,37,10
Ernest Rutherford,"""for his investigations into the disintegration of the elements, and the chemistry of radioactive substances""",Chemistry,1871,1908,1902,1937,1,23,31,6
Wilhelm Ostwald,"""in recognition of his work on catalysis and for his investigations into the fundamental principles governing chemical equilibria and rates of reaction""",Chemistry,1853,1909,1894,1932,0,25,41,15
Otto Wallach,"""in recognition of his services to organic chemistry and the chemical industry by his pioneer work in the field of alicyclic compounds""",Chemistry,1847,1910,1884,1931,0,22,37,26
Marie Curie,"""in recognition of her services to the advancement of chemistry by the discovery of the elements radium and polonium, by the isolation of radium and the study of the nature and compounds of this remarkable element""",Chemistry,1867,1911,1910,1934,0,36,43,1
Victor Grignard,"""for the discovery of the so-called Grignard reagent, which in recent years has greatly advanced the progress of organic chemistry""",Chemistry,1871,1912,1900,1935,0,30,29,12
Paul Sabatier,"""for his method of hydrogenating organic compounds in the presence of finely disintegrated metals whereby the progress of organic chemistry has been greatly advanced in recent years""",Chemistry,1854,1912,1897,1941,0,26,43,15
Alfred Werner,"""in recognition of his work on the linkage of atoms in molecules by which he has thrown new light on earlier investigations and opened up new fields of research especially in inorganic chemistry""",Chemistry,1866,1913,1892,1919,1,24,26,21
Theodore William Richards,"""in recognition of his accurate determinations of the atomic weight of a large number of chemical elements""",Chemistry,1868,1914,1900,1928,0,20,32,14
Richard Martin Willstatter,"""for his researches on plant pigments, especially chlorophyll""",Chemistry,1872,1915,1913,1942,0,22,41,2
Fritz Haber,"""for the synthesis of ammonia from its elements""",Chemistry,1868,1918,1905,1934,0,28,37,13
Walther Hermann Nernst,"""in recognition of his work in thermochemistry""",Chemistry,1864,1920,1906,1941,1,23,42,14
Frederick Soddy,"""for his contributions to our knowledge of the chemistry of radioactive substances, and his investigations into the origin and nature of isotopes""",Chemistry,1877,1921,1909,1956,0,21,32,12
Francis William Aston,"""for his discovery, by means of his mass spectrograph, of isotopes, in a large number of non-radioactive elements, and for his enunciation of the whole-number rule""",Chemistry,1877,1922,1919,1945,0,19,42,3
Fritz Pregl,"""for his invention of the method of micro-analysis of organic substances""",Chemistry,1869,1923,1911,1930,0,25,42,12
Richard Adolf Zsigmondy,"""for his demonstration of the heterogenous nature of colloid solutions and for the methods he used, which have since become fundamental in modern colloid chemistry""",Chemistry,1865,1925,1903,1929,0,26,38,22
The (Theodor) Svedberg,"""for his work on disperse systems""",Chemistry,1884,1926,1913,1971,0,24,29,13
Heinrich Otto Wieland,"""for his investigations of the constitution of the bile acids and related substances""",Chemistry,1877,1927,1932,1957,0,24,55,-5
Adolf Otto Reinhold Windaus,"""for the services rendered through his research into the constitution of the sterols and their connection with the vitamins""",Chemistry,1876,1928,1919,1958,0,24,43,9
Arthur Harden,"""for their investigations on the fermentation of sugar and fermentative enzymes""",Chemistry,1865,1929,1911,1940,0,23,46,18
Hans Karl August Simon von Euler-Chelpin,"""for their investigations on the fermentation of sugar and fermentative enzymes""",Chemistry,1873,1929,1914,1964,0,22,41,15
Hans Fischer,"""for his researches into the constitution of haemin and chlorophyll and especially for his synthesis of haemin""",Chemistry,1881,1930,1929,1945,0,27,48,1
Friedrich Bergius,"""in recognition of their contributions to the invention and development of chemical high pressure methods""",Chemistry,1884,1931,1912,1949,0,23,28,19
Carl Bosch,"""in recognition of their contributions to the invention and development of chemical high pressure methods""",Chemistry,1874,1931,1910,1940,0,24,36,21
Irving Langmuir,"""for his discoveries and investigations in surface chemistry""",Chemistry,1881,1932,1916,1957,1,25,35,16
Harold Clayton Urey,"""for his discovery of heavy hydrogen""",Chemistry,1893,1934,1931,1981,1,30,38,3
Frederic Joliot,"""in recognition of their synthesis of new radioactive elements""",Chemistry,1900,1935,1934,1958,0,30,34,1
Irene Joilot-Curie,"""in recognition of their synthesis of new radioactive elements""",Chemistry,1897,1935,1934,1956,0,28,37,1
Petrus (Peter) Josephus Wilhelmus Debye,"""for his contributions to our knowledge of molecular structure through his investigations on dipole moments and on the diffraction of X-rays and electrons in gases""",Chemistry,1884,1936,1923,1966,1,24,39,13
Walter Norman Haworth,"""for his investigations on carbohydrates and vitamin C""",Chemistry,1883,1937,1927,1950,0,27,44,10
Paul Karrer,"""for his investigations on carotenoids, flavins and vitamins A and B2""",Chemistry,1889,1937,1930,1971,0,22,41,7
Richard Kuhn,"""for his work on carotenoids and vitamins""",Chemistry,1900,1938,1933,1967,0,22,33,5
Adolf Friedrich Johann Butenandt,"""for his work on sex hormones""",Chemistry,1903,1939,1934,1995,0,24,31,5
Leopold Ruzicka,"""for his work on polymethylenes and higher terpenes""",Chemistry,1887,1939,1925,1976,0,23,38,14
George de Hevesy,"""for his work on the use of isotopes as tracers in the study of chemical processes""",Chemistry,1885,1943,1934,1966,0,23,49,9
Otto Hahn,"""for his discovery of the fission of heavy nuclei""",Chemistry,1879,1944,1938,1968,0,22,59,6
Artturi Ilmari Virtanen,"""for his research and inventions in agricultural and nutrition chemistry, especially for his fodder preservation method""",Chemistry,1895,1945,1932,1973,0,23,37,13
John Howard Northrop,"""for their preparation of enzymes and virus proteins in a pure form""",Chemistry,1891,1946,1929,1987,0,24,38,17
Wendell Meredith Stanley,"""for their preparation of enzymes and virus proteins in a pure form""",Chemistry,1904,1946,1935,1971,0,25,31,11
James Batcheller Sumner,"""for his discovery that enzymes can be crystallized""",Chemistry,1887,1946,1926,1955,0,27,39,20
Sir Robert Robinson,"""for his investigations on plant products of biological importance, especially the alkaloids""",Chemistry,1886,1947,1925,1975,0,24,39,22
Arne Wilhelm Kaurin Tiselius,"""for his research on electrophoresis and adsorption analysis, especially for his discoveries concerning the complex nature of the serum proteins""",Chemistry,1902,1948,1937,1971,0,28,35,11
William Francis Giauque,"""for his contributions in the field of chemical thermodynamics, particularly concerning the behaviour of substances at extremely low temperatures""",Chemistry,1895,1949,1933,1982,1,27,38,16
Kurt Alder,"""for their discovery and development of the diene synthesis""",Chemistry,1902,1950,1928,1958,0,24,26,22
Otto Paul Hermann Diels,"""for their discovery and development of the diene synthesis""",Chemistry,1876,1950,1928,1954,0,23,52,22
Edwin Mattison McMillan,"""for their discoveries in the chemistry of the transuranium elements""",Chemistry,1907,1951,1941,1991,0,25,34,10
Glenn Theodore Seaborg,"""for their discoveries in the chemistry of the transuranium elements""",Chemistry,1912,1951,1942,1999,0,25,30,9
Archer John Porter Martin,"""for their invention of partition chromatography""",Chemistry,1910,1952,1941,2002,0,26,31,11
Richard Laurence Millington Synge,"""for their invention of partition chromatography""",Chemistry,1914,1952,1941,1994,0,27,27,11
Hermann Staudinger,"""for his discoveries in the field of macromolecular chemistry""",Chemistry,1881,1953,1922,1965,1,22,41,31
Linus Carl Pauling,"""for his research into the nature of the chemical bond and its application to the elucidation of the structure of complex substances""",Chemistry,1901,1954,1939,1994,1,24,38,15
Vincent du Vigneaud,"""for his work on biochemically important sulphur compounds, especially for the first synthesis of a polypeptide hormone""",Chemistry,1901,1955,1953,1978,0,26,52,2
Sir Cyril Norman Hinshelwood,"""for their researches into the mechanism of chemical reactions""",Chemistry,1897,1956,1930,1967,0,24,33,26
Nikolay Nikolaevich Semenov,"""for their researches into the mechanism of chemical reactions""",Chemistry,1896,1956,1934,1986,1,21,38,22
Lord (Alexander R.) Todd,"""for his work on nucleotides and nucleotide co-enzymes""",Chemistry,1907,1957,1949,1997,0,24,42,8
Frederick Sanger,"""for his work on the structure of proteins, especially that of insulin""",Chemistry,1918,1958,1955,,0,25,37,3
Jaroslav Heyrovsky,"""for his discovery and development of the polarographic methods of analysis""",Chemistry,1890,1959,1922,1967,0,28,32,37
Willard Frank Libby,"""for his method to use carbon-14 for age determination in archaeology, geology, geophysics, and other branches of science""",Chemistry,1908,1960,1947,1980,1,25,39,13
Melvin Calvin,"""for his research on the carbon dioxide assimilation in plants""",Chemistry,1911,1961,1948,1997,0,24,37,13
John Cowdery Kendrew,"""for their studies of the structures of globular proteins""",Chemistry,1917,1962,1957,1997,0,22,40,5
Max Ferdinand Perutz,"""for their studies of the structures of globular proteins""",Chemistry,1914,1962,1953,2002,0,26,39,9
Giulio Natta,"""for their discoveries in the field of the chemistry and technology of high polymers""",Chemistry,1903,1963,1953,1979,0,21,50,10
Karl Ziegler,"""for their discoveries in the field of the chemistry and technology of high polymers""",Chemistry,1898,1963,1953,1973,0,22,55,10
Dorothy Crowfoot Hodgkin,"""for her determinations by X-ray techniques of the structures of important biochemical substances""",Chemistry,1910,1964,1951,1994,0,22,41,13
Robert Burns Woodward,"""for his outstanding achievements in the art of organic synthesis""",Chemistry,1917,1965,1958,1979,0,20,41,7
Robert S. Mulliken,"""for his fundamental work concerning chemical bonds and the electronic structure of molecules by the molecular orbital method""",Chemistry,1896,1966,1925,1986,1,25,29,41
Manfred Eigen,"""for their studies of extremely fast chemical reactions, effected by disturbing the equilibrium by means of very short pulses of energy""",Chemistry,1927,1967,1953,,1,24,26,14
Ronald George Wreyford Norrish,"""for their studies of extremely fast chemical reactions, effected by disturbing the equilibrium by means of very short pulses of energy""",Chemistry,1897,1967,1949,1978,0,27,52,18
George Porter,"""for their studies of extremely fast chemical reactions, effected by disturbing the equilibrium by means of very short pulses of energy""",Chemistry,1920,1967,1949,2002,0,29,29,18
Lars Onsager,"""for the discovery of the reciprocal relations bearing his name, which are fundamental for the thermodynamics of irreversible processes""",Chemistry,1903,1968,1931,1976,1,32,28,37
Derek H. R. Barton,"""for their contributions to the development of the concept of conformation and its application in chemistry""",Chemistry,1918,1969,1950,1998,0,24,32,19
Odd Hassel,"""for their contributions to the development of the concept of conformation and its application in chemistry""",Chemistry,1897,1969,1934,1981,0,27,37,35
Luis F. Leloir,"""for his discovery of sugar nucleotides and their role in the biosynthesis of carbohydrates""",Chemistry,1906,1970,1955,1987,0,26,49,15
Gerhard Herzberg,"""for his contributions to the knowledge of electronic structure and geometry of molecules, particularly free radicals""",Chemistry,1904,1971,1959,1999,0,24,55,12
Christian B. Anfinsen,"""for his work on ribonuclease, especially concerning the connection between the amino acid sequence and the biologically active conformation""",Chemistry,1916,1972,1956,1995,0,27,40,16
Stanford Moore,"""for their contribution to the understanding of the connection between chemical structure and catalytic activity of the active centre of the ribonuclease molecule""",Chemistry,1913,1972,1956,1982,0,26,43,16
William H. Stein,"""for their contribution to the understanding of the connection between chemical structure and catalytic activity of the active centre of the ribonuclease molecule""",Chemistry,1911,1972,1956,1980,0,26,45,16
Ernst Otto Fischer,"""for their pioneering work, performed independently, on the chemistry of the organometallic, so called sandwich compounds""",Chemistry,1918,1973,1951,,0,34,33,22
Geoffrey Wilkinson,"""for their pioneering work, performed independently, on the chemistry of the organometallic, so called sandwich compounds""",Chemistry,1921,1973,1951,1996,0,21,30,22
Paul J. Flory,"""for his fundamental achievements, both theoretical and experimental, in the physical chemistry of the macromolecules""",Chemistry,1910,1974,1953,1985,1,24,43,21
John Warcup Cornforth,"""for his work on the stereochemistry of enzyme-catalyzed reactions""",Chemistry,1917,1975,1967,,0,24,50,8
Vladimir Prelog,"""for his research into the stereochemistry of organic molecules and reactions""",Chemistry,1906,1975,1956,1998,0,23,50,19
William N. Lipscomb,"""for his studies on the structure of boranes illuminating problems of chemical bonding""",Chemistry,1919,1976,1963,,1,27,44,13
Ilya Prigogine,"""for his contributions to non-equilibrium thermodynamics, particularly the theory of dissipative structures""",Chemistry,1917,1977,1969,2003,1,24,52,8
Peter D. Mitchell,"""for his contribution to the understanding of biological energy transfer through the formulation of the chemiosmotic theory""",Chemistry,1920,1978,1965,1992,1,31,45,13
Herbert C. Brown,"""for their development of the use of boron- and phosphorus-containing compounds, respectively, into important reagents in organic synthesis""",Chemistry,1912,1979,1956,,0,26,44,23
Georg Wittig,"""for their development of the use of boron- and phosphorus-containing compounds, respectively, into important reagents in organic synthesis""",Chemistry,1897,1979,1953,1987,0,29,56,26
Paul Berg,"""for his fundamental studies of the biochemistry of nucleic acids, with particular regard to recombinant-DNA""",Chemistry,1926,1980,1960,,0,26,34,20
Walter Gilbert,"""for their contributions concerning the determination of base sequences in nucleic acids""",Chemistry,1932,1980,1966,,0,25,34,14
Kenichi Fukui,"""for their theories, developed independently, concerning the course of chemical reactions""",Chemistry,1918,1981,1952,1998,1,30,34,29
Roald Hoffmann,"""for their theories, developed independently, concerning the course of chemical reactions""",Chemistry,1937,1981,1964,,1,25,27,17
Aaron Klug,"""for his development of crystallographic electron microscopy and his structural elucidation of biologically important nucleic acid-protein complexes""",Chemistry,1926,1982,1971,,0,27,45,11
Henry Taube,"""for his work on the mechanisms of electron transfer reactions, especially in metal complexes""",Chemistry,1915,1983,1964,,0,25,49,19
Robert Bruce Merrifield,"""for his development of methodology for chemical synthesis on a solid matrix""",Chemistry,1921,1984,1969,,0,28,48,15
Herbert A. Hauptman,"""for their outstanding achievements in the development of direct methods for the determination of crystal structures""",Chemistry,1917,1985,1953,,1,37,36,32
Jerome Karle,"""for their outstanding achievements in the development of direct methods for the determination of crystal structures""",Chemistry,1918,1985,1953,,1,25,35,32
Dudley R. Herschbach,"""for their contributions concerning the dynamics of chemical elementary processes""",Chemistry,1932,1986,1967,,0,26,35,19
Yuan T. Lee,"""for their contributions concerning the dynamics of chemical elementary processes""",Chemistry,1936,1986,1967,,0,29,31,19
John C. Polanyi,"""for their contributions concerning the dynamics of chemical elementary processes""",Chemistry,1929,1986,1960,,0,23,31,26
Donald J. Cram,"""for their development and use of molecules with structure-specific interactions of high selectivity""",Chemistry,1919,1987,1978,2001,0,28,59,9
Jean-Marie Lehn,"""for their development and use of molecules with structure-specific interactions of high selectivity""",Chemistry,1939,1987,1969,,0,24,30,18
Charles J. Pedersen,"""for their development and use of molecules with structure-specific interactions of high selectivity""",Chemistry,1904,1987,1967,1989,0,23,63,20
Johann Deisenhofer,"""for the determination of the three-dimensional structure of a photosynthetic reaction centre""",Chemistry,1943,1988,1983,,0,31,40,5
Robert Huber,"""for the determination of the three-dimensional structure of a photosynthetic reaction centre""",Chemistry,1937,1988,1983,,0,26,46,5
Hartmut Michel,"""for the determination of the three-dimensional structure of a photosynthetic reaction centre""",Chemistry,1948,1988,1982,,0,29,34,6
Sidney Altman,"""for their discovery of catalytic properties of RNA""",Chemistry,1939,1989,1982,,0,28,43,7
Thomas R. Cech,"""for their discovery of catalytic properties of RNA""",Chemistry,1947,1989,1982,,0,28,35,7
Elias James Corey,"""for his development of the theory and methodology of organic synthesis""",Chemistry,1928,1990,1954,,0,22,26,36
Richard R. Ernst,"""for his contributions to the development of the methodology of high resolution nuclear magnetic resonance (NMR) spectroscopy""",Chemistry,1933,1991,1966,,1,29,33,25
Rudolph A. Marcus,"""for his contributions to the theory of electron transfer reactions in chemical systems""",Chemistry,1923,1992,1964,,1,23,41,28
Kary Mullis,"""for his invention of the polymerase chain reaction (PCR) method""",Chemistry,1944,1993,1983,,0,29,39,10
Michael Smith,"""for his fundamental contributions to the establishment of oligonucleotide-based, site-directed mutagenesis and its development for protein studies""",Chemistry,1932,1993,1976,,0,24,44,17
George A. Olah,"""for his contribution to carbocation chemistry""",Chemistry,1927,1994,1962,,0,22,35,32
Paul J. Crutzen,"""for their work in atmospheric chemistry, particularly concerning the formation and decomposition of ozone""",Chemistry,1933,1995,1970,,0,35,37,25
Mario J. Molina,"""for their work in atmospheric chemistry, particularly concerning the formation and decomposition of ozone""",Chemistry,1943,1995,1974,,0,29,31,21
F. Sherwood Rowland,"""for their work in atmospheric chemistry, particularly concerning the formation and decomposition of ozone""",Chemistry,1927,1995,1970,,0,25,43,25
Robert F. Curl Jr.,"""for their discovery of fullerenes""",Chemistry,1933,1996,1985,,0,24,52,11
Sir Harold W. Kroto,"""for their discovery of fullerenes""",Chemistry,1939,1996,1985,,0,25,46,11
Richard E. Smalley,"""for their discovery of fullerenes""",Chemistry,1943,1996,1985,,0,30,42,11
Paul Boyer,"""for their elucidation of the enzymatic mechanism underlying the synthesis of adenosine triphosphate (ATP)""",Chemistry,1918,1997,1972,,0,25,54,25
Jens C. Skou,"""for the first discovery of an ion-transporting enzyme, Na+, K+ -ATPase""",Chemistry,1918,1997,1957,,0,26,39,40
John Walker,"""for their elucidation of the enzymatic mechanism underlying the synthesis of adenosine triphosphate (ATP)""",Chemistry,1941,1997,1986,,0,28,45,11
Walter Kohn,"""for his development of the density-functional theory""",Chemistry,1923,1998,1964,,1,25,41,34
John A. Pople,"""for his development of computational methods in quantum chemistry""",Chemistry,1925,1998,1967,2004,1,26,42,31
Ahmed H. Zewail,"""for his studies of the transition states of chemical reactions using femtosecond spectroscopy""",Chemistry,1946,1999,1987,,0,28,41,12
Alan J. Heeger,"""for the discovery and development of conductive polymers""",Chemistry,1936,2000,1977,,0,25,41,23
Alan G. MacDiarmid,"""for the discovery and development of conductive polymers""",Chemistry,1927,2000,1977,,0,26,50,23
Hideki Shirakawa,"""for the discovery and development of conductive polymers""",Chemistry,1936,2000,1977,,0,30,41,23
William S. Knowles,"""for their work on chirally catalysed hydrogenation reactions""",Chemistry,1917,2001,1968,,0,25,51,33
Ryoji Noyori,"""for their work on chirally catalysed hydrogenation reactions""",Chemistry,1938,2001,1980,,0,29,42,21
K. Barry Sharpless,"""for his work on chirally catalysed oxidation reactions""",Chemistry,1941,2001,1980,,0,27,39,21
John Fenn,"""for their development of soft desorption ionisation methods for mass spectrometric analyses of biological macromolecules""",Chemistry,1917,2002,1988,,1,23,71,14
Koichi Tanaka,"""for their development of soft desorption ionisation methods for mass spectrometric analyses of biological macromolecules""",Chemistry,1959,2002,1986,,0,24,27,16
Kurt Wuthrich,"""for his development of nuclear magnetic resonance spectroscopy for determining the three-dimensional structure of biological macromolecules in solution""",Chemistry,1938,2002,1979,,0,26,41,23
Peter Agre,"""for the discovery of water channels""",Chemistry,1949,2003,1991,,0,25,42,12
Roderick MacKinnon,"""for structural and mechanistic studies of ion channels""",Chemistry,1956,2003,1998,,0,26,42,5
Aaron Ciechanover,"""for the discovery of ubiquitin-mediated protein degradation""",Chemistry,1947,2004,1983,,0,27,36,21
Avram Hershko,"""for the discovery of ubiquitin-mediated protein degradation""",Chemistry,1937,2004,1983,,0,28,46,21
Irwin Rose,"""for the discovery of ubiquitin-mediated protein degradation""",Chemistry,1926,2004,1983,,0,26,57,21
Yves Chauvin,"""for the development of the metathesis method in organic synthesis""",Chemistry,1930,2005,1971,,0,24,41,34
Robert H. Grubbs,"""for the development of the metathesis method in organic synthesis""",Chemistry,1942,2005,1992,,0,26,50,13
Richard R. Schrock,"""for the development of the metathesis method in organic synthesis""",Chemistry,1945,2005,1990,,0,26,45,15
Roger D. Kornberg,"""for his studies of the molecular basis of eukaryotic transcription""",Chemistry,1947,2006,2001,,0,25,54,5
Gerhard Ertl,"""for his studies of chemical processes on solid surfaces""",Chemistry,1936,2007,1974,,0,29,38,33
Martin Chalfie,"""for the discovery and development of the green fluorescent protein, GFP""",Chemistry,1947,2008,1994,,0,30,47,14
Osamu Shimomura,"""for the discovery and development of the green fluorescent protein, GFP""",Chemistry,1928,2008,1962,,0,32,34,46
Roger Y. Tsien,"""for the discovery and development of the green fluorescent protein, GFP""",Chemistry,1952,2008,1996,,0,25,44,12
Emil Adolf von Behring,"""for his work on serum therapy, especially its application against diphtheria, by which he has opened a new road in the domain of medical science and thereby placed in the hands of the physician a victorious weapon against illness and deaths""",Medicine,1854,1901,1890,1917,0,26,36,11
Ronald Ross,"""for his work on malaria, by which he has shown how it enters the organism and thereby has laid the foundation for successful research on this disease and methods of combating it""",Medicine,1857,1902,1897,1932,0,22,40,5
Niels Ryberg Finsen,"""in recognition of his contribution to the treatment of diseases, especially lupus vulgaris, with concentrated light radiation, whereby he has opened a new avenue for medical science""",Medicine,1860,1903,1895,1904,0,30,35,8
Ivan Petrovich Pavlov,"""in recognition of his work on the physiology of digestion, through which knowledge on vital aspects of the subject has been transformed and enlarged""",Medicine,1849,1904,1895,1936,0,34,46,9
Robert Koch,"""for his investigations and discoveries in relation to tuberculosis""",Medicine,1843,1905,1882,1910,0,23,39,23
Santiago Ramon y Cajal,"""in recognition of their work on the structure of the nervous system""",Medicine,1852,1906,1889,1934,1,25,37,17
Camillo Golgi,"""in recognition of their work on the structure of the nervous system""",Medicine,1843,1906,1890,1926,0,22,47,16
Charles Louis Alphonse Laveran,"""in recognition of his work on the role played by protozoa in causing diseases""",Medicine,1845,1907,1884,1922,0,22,39,23
Paul Ehrlich,"""in recognition of their work on immunity""",Medicine,1854,1908,1896,1915,0,24,42,12
Ilya Ilyich Mechnikov,"""in recognition of their work on immunity""",Medicine,1845,1908,1883,1916,0,22,38,25
Emil Theodor Kocher,"""for his work on the physiology, pathology and surgery of the thyroid gland""",Medicine,1841,1909,1883,1917,0,24,42,26
Albrecht Kossel,"""in recognition of the contributions to our knowledge of cell chemistry made through his work on proteins, including the nucleic substances""",Medicine,1853,1910,1881,1927,0,25,28,29
Allvar Gullstrand,"""for his work on the dioptrics of the eye""",Medicine,1862,1911,1903,1930,0,28,41,8
Alexis Carrel,"""in recognition of his work on vascular suture and the transplantation of blood vessels and organs""",Medicine,1873,1912,1902,1944,0,27,29,10
Charles Robert Richet,"""in recognition of his work on anaphylaxis""",Medicine,1850,1913,1902,1935,0,28,52,11
Robert Barany,"""for his work on the physiology and pathology of the vestibular apparatus""",Medicine,1876,1914,1905,1936,0,24,29,9
Jules Bordet,"""for his discoveries relating to immunity""",Medicine,1870,1919,1900,1961,0,22,30,19
Schack August Steenberg Krogh,"""for his discovery of the capillary motor regulating mechanism""",Medicine,1874,1920,1910,1949,0,29,36,10
Archibald Hill,"""for his discovery relating to the production of heat in the muscle""",Medicine,1886,1922,1912,1977,0,21,26,10
Otto Fritz Meyerhof,"""for his discovery of the fixed relationship between the consumption of oxygen and the metabolism of lactic acid in the muscle""",Medicine,1884,1922,1919,1951,0,25,35,3
Frederick Grant Banting,"""for the discovery of insulin""",Medicine,1891,1923,1920,1941,0,31,29,3
John James Rickard Macleod,"""for the discovery of insulin""",Medicine,1876,1923,1920,1935,0,22,44,3
Willem Einthoven,"""for his discovery of the mechanism of the electrocardiogram""",Medicine,1860,1924,1910,1927,0,25,50,14
Johannes Andreas Grib Fibiger,"""for his discovery of the Spiroptera carcinoma""",Medicine,1867,1926,1910,1928,0,23,43,16
Julius Wagner-Jauregg,"""for his discovery of the therapeutic value of malaria inoculation in the treatment of dementia paralytica""",Medicine,1857,1927,1917,1940,0,23,60,10
Charles Jules Henri Nicolle,"""for his work on typhus""",Medicine,1866,1928,1909,1935,1,27,43,19
Christiaan Eijkman,"""for his discovery of the antineuritic vitamin""",Medicine,1858,1929,1890,1930,0,25,32,39
Sir Frederick Gowland Hopkins,"""for his discovery of the growth-stimulating vitamins""",Medicine,1861,1929,1906,1947,0,33,45,23
Karl Landsteiner,"""for his discovery of human blood groups""",Medicine,1868,1930,1901,1943,0,23,33,29
Otto Heinrich Warburg,"""for his discovery of the nature and mode of action of the respiratory enzyme""",Medicine,1883,1931,1922,1970,0,23,39,9
Edgar Douglas Adrian,"""for their discoveries regarding the functions of neurons""",Medicine,1889,1932,1928,1977,0,26,39,4
Sir Charles Scott Sherrington,"""for their discoveries regarding the functions of neurons""",Medicine,1857,1932,1906,1952,0,29,49,26
Thomas Hunt Morgan,"""for his discoveries concerning the role played by the chromosome in heredity""",Medicine,1866,1933,1912,1945,0,25,46,21
George Richards Minot,"""for their discoveries concerning liver therapy in cases of anaemia""",Medicine,1885,1934,1926,1950,0,27,41,8
William Parry Murphy,"""for their discoveries concerning liver therapy in cases of anaemia""",Medicine,1892,1934,1926,1987,0,30,34,8
George Hoyt Whipple,"""for their discoveries concerning liver therapy in cases of anaemia""",Medicine,1878,1934,1920,1976,0,27,42,14
Hans Spemann,"""for his discovery of the organizer effect in embryonic development""",Medicine,1869,1935,1924,1941,0,26,55,11
Sir Henry Hallett Dale,"""for their discoveries relating to chemical transmission of nerve impulses""",Medicine,1875,1936,1914,1968,0,34,39,22
Otto Loewi,"""for their discoveries relating to chemical transmission of nerve impulses""",Medicine,1873,1936,1921,1961,0,23,48,15
Albert von Szent-Gyorgyi Nagyrapolt,"""for his discoveries in connection with the biological combustion processes, with special reference to vitamin C and the catalysis of fumaric acid""",Medicine,1893,1937,1928,1986,0,35,35,9
Corneille Jean Francois Heymans,"""for the discovery of the role played by the sinus and aortic mechanisms in the regulation of respiration""",Medicine,1892,1938,1928,1968,0,28,36,10
Gerhard Domagk,"""for the discovery of the antibacterial effects of prontosil""",Medicine,1895,1939,1932,1964,0,26,37,7
Henrik Dam,"""for his discovery of vitamin K""",Medicine,1895,1943,1934,1976,0,39,39,9
Edward Adelbert Doisy,"""for his discovery of the chemical nature of vitamin K""",Medicine,1893,1943,1939,1986,0,27,46,4
Joseph Erlanger,"""for their discoveries relating to the highly differentiated functions of single nerve fibres""",Medicine,1874,1944,1922,1965,0,25,48,22
Herbert Spencer Gasser,"""for their discoveries relating to the highly differentiated functions of single nerve fibres""",Medicine,1888,1944,1922,1963,0,27,34,22
Ernst Boris Chain,"""for the discovery of penicillin and its curative effect in various infectious diseases""",Medicine,1906,1945,1940,1979,1,24,34,5
Sir Alexander Fleming,"""for the discovery of penicillin and its curative effect in various infectious diseases""",Medicine,1881,1945,1928,1955,0,27,47,17
Sir Howard Walter Florey,"""for the discovery of penicillin and its curative effect in various infectious diseases""",Medicine,1898,1945,1940,1968,0,29,42,5
Hermann Joseph Muller,"""for the discovery of the production of mutations by means of X-ray irradiation""",Medicine,1890,1946,1926,1967,0,26,36,20
Carl Cori,"""for their discovery of the course of the catalytic conversion of glycogen""",Medicine,1896,1947,1936,1984,0,24,40,11
Gerty Cori,"""for their discovery of the course of the catalytic conversion of glycogen""",Medicine,1896,1947,1936,1957,0,24,40,11
Bernardo Alberto Houssay,"""for his discovery of the part played by the hormone of the anterior pituitary lobe in the metabolism of sugar""",Medicine,1887,1947,1933,1971,0,23,46,14
Paul Hermann Muller,"""for his discovery of the high efficiency of DDT as a contact poison against several arthropods""",Medicine,1899,1948,1939,1965,0,26,40,9
Antonio Caetano de Abreu Freire Egas Moniz,"""for his discovery of the therapeutic value of leucotomy in certain psychoses""",Medicine,1874,1949,1936,1955,0,28,62,13
Philip Showalter Hench,"""for their discoveries relating to the hormones of the adrenal cortex, their structure and biological effects""",Medicine,1896,1950,1948,1965,0,24,52,2
Edward Calvin Kendall,"""for their discoveries relating to the hormones of the adrenal cortex, their structure and biological effects""",Medicine,1886,1950,1939,1972,0,24,53,11
Tadeus Reichstein,"""for their discoveries relating to the hormones of the adrenal cortex, their structure and biological effects""",Medicine,1897,1950,1937,1996,0,25,40,13
Max Theiler,"""for his discoveries concerning yellow fever and how to combat it""",Medicine,1899,1951,1927,1972,0,23,28,24
Selman Abraham Waksman,"""for his discovery of streptomycin, the first antibiotic effective against tuberculosis""",Medicine,1888,1952,1943,1973,0,30,55,9
Hans Adolf Krebs,"""for his discovery of the citric acid cycle""",Medicine,1900,1953,1937,1981,1,25,37,16
Fritz Albert Lipmann,"""for his discovery of co-enzyme A and its importance for intermediary metabolism""",Medicine,1899,1953,1946,1986,0,25,47,7
John Franklin Enders,"""for their discovery of the ability of poliomyelitis viruses to grow in cultures of various types of tissue""",Medicine,1897,1954,1949,1985,0,33,52,5
Frederick Chapman Robbins,"""for their discovery of the ability of poliomyelitis viruses to grow in cultures of various types of tissue""",Medicine,1916,1954,1949,2003,0,24,33,5
Thomas Huckle Weller,"""for their discovery of the ability of poliomyelitis viruses to grow in cultures of various types of tissue""",Medicine,1915,1954,1949,,0,25,34,5
Axel Hugo Theodor Theorell,"""for his discoveries concerning the nature and mode of action of oxidation enzymes""",Medicine,1903,1955,1939,1982,1,27,36,16
Andre F. Cournand,"""for their discoveries concerning heart catheterization and pathological changes in the circulatory system""",Medicine,1895,1956,1941,1988,0,35,46,15
Werner Forssmann,"""for their discoveries concerning heart catheterization and pathological changes in the circulatory system""",Medicine,1904,1956,1929,1979,0,25,25,27
Dickinson W. Richards,"""for their discoveries concerning heart catheterization and pathological changes in the circulatory system""",Medicine,1895,1956,1941,1973,0,28,46,15
Daniel Bovet,"""for his discoveries relating to synthetic compounds that inhibit the action of certain body substances, and especially their action on the vascular system and the skeletal muscles""",Medicine,1907,1957,1948,1992,0,22,41,9
George Beadle,"""for their discovery that genes act by regulating definite chemical events""",Medicine,1903,1958,1941,1989,0,28,38,17
Joshua Lederberg,"""for his discoveries concerning genetic recombination and the organization of the genetic material of bacteria""",Medicine,1925,1958,1945,,0,22,20,13
Edward Tatum,"""for their discovery that genes act by regulating definite chemical events""",Medicine,1909,1958,1941,1975,0,25,32,17
Arthur Kornberg,"""for their discovery of the mechanisms in the biological synthesis of ribonucleic acid and deoxyribonucleic acid""",Medicine,1918,1959,1956,,0,23,38,3
Severo Ochoa,"""for their discovery of the mechanisms in the biological synthesis of ribonucleic acid and deoxyribonucleic acid""",Medicine,1905,1959,1955,1993,0,24,50,4
Sir Frank Macfarlane Burnet,"""for discovery of acquired immunological tolerance""",Medicine,1899,1960,1947,1985,1,29,48,13
Peter Brian Medawar,"""for discovery of acquired immunological tolerance""",Medicine,1915,1960,1947,1987,0,20,32,13
Georg von Bekesy,"""for his discoveries of the physical mechanism of stimulation within the cochlea""",Medicine,1899,1961,1928,1972,0,24,29,33
Francis Harry Compton Crick,"""for their discoveries concerning the molecular structure of nucleic acids and its significance for information transfer in living material""",Medicine,1916,1962,1953,,1,38,37,9
James Dewey Watson,"""for their discoveries concerning the molecular structure of nucleic acids and its significance for information transfer in living material""",Medicine,1928,1962,1953,,1,22,25,9
Maurice Hugh Frederick Wilkins,"""for their discoveries concerning the molecular structure of nucleic acids and its significance for information transfer in living material""",Medicine,1916,1962,1953,,0,24,37,9
Sir John Carew Eccles,"""for their discoveries concerning the ionic mechanisms involved in excitation and inhibition in the peripheral and central portions of the nerve cell membrane""",Medicine,1903,1963,1951,1997,0,26,48,12
Alan Lloyd Hodgkin,"""for their discoveries concerning the ionic mechanisms involved in excitation and inhibition in the peripheral and central portions of the nerve cell membrane""",Medicine,1914,1963,1948,1998,0,21,34,15
Andrew Fielding Huxley,"""for their discoveries concerning the ionic mechanisms involved in excitation and inhibition in the peripheral and central portions of the nerve cell membrane""",Medicine,1917,1963,1948,,0,22,31,15
Konrad Bloch,"""for their discoveries concerning the mechanism and regulation of the cholesterol and fatty acid metabolism""",Medicine,1912,1964,1942,2000,0,26,30,22
Feodor Lynen,"""for their discoveries concerning the mechanism and regulation of the cholesterol and fatty acid metabolism""",Medicine,1911,1964,1951,1979,0,26,40,13
Francois Jacob,"""for their discoveries concerning genetic control of enzyme and virus synthesis""",Medicine,1920,1965,1958,,0,27,38,7
Andre Lwoff,"""for their discoveries concerning genetic control of enzyme and virus synthesis""",Medicine,1902,1965,1953,1994,0,25,51,12
Jacques Monod,"""for their discoveries concerning genetic control of enzyme and virus synthesis""",Medicine,1910,1965,1958,1976,0,31,48,7
Charles Brenton Huggins,"""for his discoveries concerning hormonal treatment of prostatic cancer""",Medicine,1901,1966,1941,1997,0,23,40,25
Peyton Rous,"""for his discovery of tumour-inducing viruses""",Medicine,1879,1966,1934,1970,0,26,55,32
Ragnar Granit,"""for their discoveries concerning the primary physiological and chemical visual processes in the eye""",Medicine,1900,1967,1937,1991,0,27,37,30
Haldan Keffer Hartline,"""for their discoveries concerning the primary physiological and chemical visual processes in the eye""",Medicine,1903,1967,1938,1983,0,24,35,29
George Wald,"""for their discoveries concerning the primary physiological and chemical visual processes in the eye""",Medicine,1906,1967,1935,1997,0,26,29,32
Robert W. Holley,"""for their interpretation of the genetic code and its function in protein synthesis""",Medicine,1922,1968,1965,1993,0,25,43,3
Har Gobind Khorana,"""for their interpretation of the genetic code and its function in protein synthesis""",Medicine,1922,1968,1956,,0,26,34,12
Marshall W. Nirenberg,"""for their interpretation of the genetic code and its function in protein synthesis""",Medicine,1927,1968,1962,,0,30,35,6
Max Delbruck,"""for their discoveries concerning the replication mechanism and the genetic structure of viruses""",Medicine,1906,1969,1942,1981,1,23,36,27
Alfred D. Hershey,"""for their discoveries concerning the replication mechanism and the genetic structure of viruses""",Medicine,1908,1969,1946,,0,26,38,23
Salvador E. Luria,"""for their discoveries concerning the replication mechanism and the genetic structure of viruses""",Medicine,1912,1969,1946,1991,1,23,34,23
Julius Axelrod,"""for their discoveries concerning the humoral transmittors in the nerve terminals and the mechanism for their storage, release and inactivation""",Medicine,1912,1970,1961,,0,43,49,9
Sir Bernard Katz,"""for their discoveries concerning the humoral transmittors in the nerve terminals and the mechanism for their storage, release and inactivation""",Medicine,1911,1970,1954,2003,0,23,43,16
Ulf von Euler,"""for their discoveries concerning the humoral transmittors in the nerve terminals and the mechanism for their storage, release and inactivation""",Medicine,1905,1970,1958,1983,0,25,53,12
"Earl W. Sutherland, Jr.","""for his discoveries concerning the mechanisms of the action of hormones""",Medicine,1915,1971,1954,1974,0,27,39,17
Gerald M. Edelman,"""for their discoveries concerning the chemical structure of antibodies""",Medicine,1929,1972,1960,,0,25,31,12
Rodney R. Porter,"""for their discoveries concerning the chemical structure of antibodies""",Medicine,1917,1972,1959,1985,0,31,42,13
Konrad Lorenz,"""for their discoveries concerning organization and elicitation of individual and social behaviour patterns""",Medicine,1903,1973,1938,1989,0,25,35,35
Nikolaas Tinbergen,"""for their discoveries concerning organization and elicitation of individual and social behaviour patterns""",Medicine,1907,1973,1951,1988,0,25,44,22
Karl von Frisch,"""for their discoveries concerning organization and elicitation of individual and social behaviour patterns""",Medicine,1886,1973,1915,1982,0,24,29,58
Albert Claude,"""for their discoveries concerning the structural and functional organization of the cell""",Medicine,1899,1974,1945,1983,0,29,46,29
George E. Palade,"""for their discoveries concerning the structural and functional organization of the cell""",Medicine,1912,1974,1952,,0,28,40,22
Christian de Duve,"""for their discoveries concerning the structural and functional organization of the cell""",Medicine,1917,1974,1949,,0,24,32,25
David Baltimore,"""for their discoveries concerning the interaction between tumour viruses and the genetic material of the cell""",Medicine,1938,1975,1970,,0,26,32,5
Renato Dulbecco,"""for their discoveries concerning the interaction between tumour viruses and the genetic material of the cell""",Medicine,1914,1975,1959,,0,22,45,16
Howard Martin Temin,"""for their discoveries concerning the interaction between tumour viruses and the genetic material of the cell""",Medicine,1934,1975,1970,1994,1,25,36,5
Baruch S. Blumberg,"""for their discoveries concerning new mechanisms for the origin and dissemination of infectious diseases""",Medicine,1925,1976,1969,,0,32,44,7
D. Carleton Gajdusek,"""for their discoveries concerning new mechanisms for the origin and dissemination of infectious diseases""",Medicine,1923,1976,1955,,0,23,32,21
Roger Guillemin,"""for their discoveries concerning the peptide hormone production of the brain""",Medicine,1924,1977,1969,,0,25,45,8
Andrew W. Schally,"""for their discoveries concerning the peptide hormone production of the brain""",Medicine,1926,1977,1969,,0,31,43,8
Rosalyn Yalow,"""for the development of radioimmunoassays of peptide hormones""",Medicine,1921,1977,1959,,0,24,38,18
Werner Arber,"""for the discovery of restriction enzymes and their application to problems of molecular genetics""",Medicine,1929,1978,1961,,1,29,32,17
Daniel Nathans,"""for the discovery of restriction enzymes and their application to problems of molecular genetics""",Medicine,1928,1978,1972,1999,0,26,44,6
Hamilton O. Smith,"""for the discovery of restriction enzymes and their application to problems of molecular genetics""",Medicine,1931,1978,1967,,0,23,36,11
Allan M. Cormack,"""for the development of computer assisted tomography""",Medicine,1924,1979,1963,1998,0,25,39,16
Godfrey N. Hounsfield,"""for the development of computer assisted tomography""",Medicine,1919,1979,1971,,0,32,52,8
Baruj Benacerraf,"""for their discoveries concerning genetically determined structures on the cell surface that regulate immunological reactions""",Medicine,1920,1980,1961,,0,25,41,19
Jean Dausset,"""for their discoveries concerning genetically determined structures on the cell surface that regulate immunological reactions""",Medicine,1916,1980,1965,,0,24,49,15
George D. Snell,"""for their discoveries concerning genetically determined structures on the cell surface that regulate immunological reactions""",Medicine,1903,1980,1951,1996,0,27,48,29
David H. Hubel,"""for their discoveries concerning information processing in the visual system""",Medicine,1926,1981,1959,,0,27,33,22
Roger W. Sperry,"""for his discoveries concerning the functional specialization of the cerebral hemispheres""",Medicine,1913,1981,1962,1994,0,28,49,19
Torsten N. Wiesel,"""for their discoveries concerning information processing in the visual system""",Medicine,1924,1981,1959,,0,30,35,22
Sune K. Bergstrom,"""for their discoveries concerning prostaglandins and related biologically active substances""",Medicine,1916,1982,1962,,0,26,46,20
Bengt I. Samuelsson,"""for their discoveries concerning prostaglandins and related biologically active substances""",Medicine,1934,1982,1962,,0,26,28,20
John R. Vane,"""for their discoveries concerning prostaglandins and related biologically active substances""",Medicine,1927,1982,1971,,0,26,44,11
Barbara McClintock,"""for her discovery of mobile genetic elements""",Medicine,1902,1983,1950,1992,0,25,48,33
Niels K. Jerne,"""for theories concerning the specificity in development and control of the immune system and the discovery of the principle for production of monoclonal antibodies""",Medicine,1911,1984,1964,1994,1,40,53,20
Georges J.F. Kohler,"""for theories concerning the specificity in development and control of the immune system and the discovery of the principle for production of monoclonal antibodies""",Medicine,1946,1984,1975,1995,0,28,29,9
Cesar Milstein,"""for theories concerning the specificity in development and control of the immune system and the discovery of the principle for production of monoclonal antibodies""",Medicine,1927,1984,1975,2002,0,30,48,9
Michael S. Brown,"""for their discoveries concerning the regulation of cholesterol metabolism""",Medicine,1941,1985,1973,,0,25,32,12
Joseph L. Goldstein,"""for their discoveries concerning the regulation of cholesterol metabolism""",Medicine,1940,1985,1973,,0,26,33,12
Stanley Cohen,"""for their discoveries of growth factors""",Medicine,1922,1986,1953,,0,26,31,33
Rita Levi-Montalcini,"""for their discoveries of growth factors""",Medicine,1909,1986,1953,,0,27,44,33
Susumu Tonegawa,"""for his discovery of the genetic principle for generation of antibody diversity""",Medicine,1939,1987,1976,,0,29,37,11
Sir James W. Black,"""for their discoveries of important principles for drug treatment""",Medicine,1924,1988,1964,,0,22,40,24
Gertrude B. Elion,"""for their discoveries of important principles for drug treatment""",Medicine,1918,1988,1952,1999,0,23,34,36
George H. Hitchings,"""for their discoveries of important principles for drug treatment""",Medicine,1905,1988,1952,1998,0,28,47,36
J. Michael Bishop,"""for their discovery of the cellular origin of retroviral oncogenes""",Medicine,1936,1989,1975,,0,26,39,14
Harold E. Varmus,"""for their discovery of the cellular origin of retroviral oncogenes""",Medicine,1939,1989,1975,,0,29,36,14
Joseph E. Murray,"""for their discoveries concerning organ and cell transplantation in the treatment of human disease""",Medicine,1919,1990,1954,,0,24,35,36
E. Donnall Thomas,"""for their discoveries concerning organ and cell transplantation in the treatment of human disease""",Medicine,1920,1990,1956,,0,26,36,34
Erwin Neher,"""for their discoveries concerning the function of single ion channels in cells""",Medicine,1944,1991,1976,,0,26,32,15
Bert Sakmann,"""for their discoveries concerning the function of single ion channels in cells""",Medicine,1942,1991,1976,,0,32,34,15
Edmond H. Fischer,"""for their discoveries concerning reversible protein phosphorylation as a biological regulatory mechanism""",Medicine,1920,1992,1955,,0,27,35,37
Edwin G. Krebs,"""for their discoveries concerning reversible protein phosphorylation as a biological regulatory mechanism""",Medicine,1918,1992,1955,,0,25,37,37
Richard J. Roberts,"""for their discoveries of split genes""",Medicine,1943,1993,1977,,0,26,34,16
Phillip A. Sharp,"""for their discoveries of split genes""",Medicine,1944,1993,1977,,0,25,33,16
Alfred G. Gilman,"""for their discovery of G-proteins and the role of these proteins in signal transduction in cells""",Medicine,1941,1994,1980,,0,28,39,14
Martin Rodbell,"""for their discovery of G-proteins and the role of these proteins in signal transduction in cells""",Medicine,1925,1994,1970,1998,0,29,45,24
Edward B. Lewis,"""for their discoveries concerning the genetic control of early embryonic development""",Medicine,1918,1995,1978,,0,24,60,17
Christiane Nusslein-Volhard,"""for their discoveries concerning the genetic control of early embryonic development""",Medicine,1942,1995,1978,,0,31,36,17
Eric F. Wieschaus,"""for their discoveries concerning the genetic control of early embryonic development""",Medicine,1947,1995,1978,,0,27,31,17
Peter C. Doherty,"""for their discoveries concerning the specificity of the cell mediated immune defence""",Medicine,1940,1996,1974,,0,30,34,22
Rolf M. Zinkernagel,"""for their discoveries concerning the specificity of the cell mediated immune defence""",Medicine,1944,1996,1974,,0,31,30,22
Stanley B. Prusiner,"""for his discovery of Prions - a new biological principle of infection""",Medicine,1942,1997,1982,,0,26,40,15
Robert F. Furchgott,"""for their discoveries concerning nitric oxide as a signalling molecule in the cardiovascular system""",Medicine,1916,1998,1980,,0,24,64,18
Louis J. Ignarro,"""for their discoveries concerning nitric oxide as a signalling molecule in the cardiovascular system""",Medicine,1941,1998,1977,,0,25,36,21
Ferid Murad,"""for their discoveries concerning nitric oxide as a signalling molecule in the cardiovascular system""",Medicine,1936,1998,1977,,0,29,41,21
Gunter Blobel,"""for the discovery that proteins have intrinsic signals that govern their transport and localization in the cell""",Medicine,1936,1999,1972,,0,30,36,27
Arvid Carlsson,"""for their discoveries concerning signal transduction in the nervous system""",Medicine,1923,2000,1948,,0,28,25,52
Paul Greengard,"""for their discoveries concerning signal transduction in the nervous system""",Medicine,1925,2000,1969,,0,28,44,31
Eric R. Kandel,"""for their discoveries concerning signal transduction in the nervous system""",Medicine,1929,2000,1981,,0,27,52,19
Leland H. Hartwell,"""for their discoveries of key regulators of the cell cycle""",Medicine,1939,2001,1970,,0,25,31,31
Tim Hunt,"""for their discoveries of key regulators of the cell cycle""",Medicine,1943,2001,1982,,0,25,39,19
Sir Paul M. Nurse,"""for their discoveries of key regulators of the cell cycle""",Medicine,1949,2001,1981,,0,24,32,20
Sydney Brenner,"""for their discoveries concerning genetic regulation of organ development and programmed cell death'""",Medicine,1927,2002,1974,,0,27,47,28
H. Robert Horvitz,"""for their discoveries concerning genetic regulation of organ development and programmed cell death'""",Medicine,1947,2002,1986,,0,27,39,16
John E. Sulston,"""for their discoveries concerning genetic regulation of organ development and programmed cell death'""",Medicine,1942,2002,1976,,0,24,34,26
Paul C. Lauterbur,"""for their discoveries concerning magnetic resonance imaging""",Medicine,1929,2003,1973,,1,33,44,30
Richard Axel,"""for their discoveries of odorant receptors and the organization of the olfactory system""",Medicine,1946,2004,1991,,0,24,45,13
Linda B. Buck,"""for their discoveries of odorant receptors and the organization of the olfactory system""",Medicine,1947,2004,1991,,0,33,44,13
Barry J. Marshall,"""for their discovery of the bacterium Helicobacter pylori and its role in gastritis and peptic ulcer disease""",Medicine,1951,2005,1984,,0,23,33,21
J. Robin Warren,"""for their discovery of the bacterium Helicobacter pylori and its role in gastritis and peptic ulcer disease""",Medicine,1937,2005,1984,,0,24,47,21
Andrew Z. Fire,"""for their discovery of RNA interference - gene silencing by double-stranded RNA""",Medicine,1959,2006,1998,,0,24,39,8
Craig C. Mello,"""for their discovery of RNA interference - gene silencing by double-stranded RNA""",Medicine,1960,2006,1998,,0,30,38,8
Mario R. Capecchi,"""for their discoveries of principles for introducing specific gene modifications in mice by the use of embryonic stem cells""",Medicine,1937,2007,1987,,0,30,50,20
Sir Martin J. Evans,"""for their discoveries of principles for introducing specific gene modifications in mice by the use of embryonic stem cells""",Medicine,1941,2007,1981,,0,28,40,26
Oliver Smithies,"""for their discoveries of principles for introducing specific gene modifications in mice by the use of embryonic stem cells""",Medicine,1925,2007,1985,,0,26,60,22
Francoise Barre-Sinoussi,"""for their discovery of human immunodeficiency virus""",Medicine,1947,2008,1983,,0,28,36,25
Harold zur Hausen,"""for his discovery of human papilloma viruses causing cervical cancer""",Medicine,1936,2008,1983,,0,24,47,25
Luc Montagnier,"""for their discovery of human immunodeficiency virus""",Medicine,1932,2008,1983,,0,28,51,25
Wilhelm Conrad Rontgen,"""in recognition of the extraordinary services he has rendered by the discovery of the remarkable rays subsequently named after him""",Physics,1845,1901,1895,1923,0,24,50,6
Hendrik Antoon Lorentz,"""in recognition of the extraordinary service they rendered by their researches into the influence of magnetism upon radiation phenomena""",Physics,1853,1902,1892,1928,1,22,39,10
Pieter Zeeman,"""in recognition of the extraordinary service they rendered by their researches into the influence of magnetism upon radiation phenomena""",Physics,1865,1902,1896,1943,0,28,31,6
Antoine Henri Becquerel,"""in recognition of the extraordinary services he has rendered by his discovery of spontaneous radioactivity""",Physics,1852,1903,1896,1908,0,25,44,7
Marie Curie,"""in recognition of the extraordinary services they have rendered by their joint researches on the radiation phenomena discovered by Professor Henri Becquerel""",Physics,1867,1903,1898,1934,0,26,31,5
Pierre Curie,"""in recognition of the extraordinary services they have rendered by their joint researches on the radiation phenomena discovered by Professor Henri Becquerel""",Physics,1859,1903,1898,1906,0,36,39,5
Lord Rayleigh (John William Strutt),"""for his investigations of the densities of the most important gases and for his discovery of argon in connection with these studies""",Physics,1842,1904,1894,1919,0,23,52,10
Philipp Eduard Anton von Lenard,"""for his work on cathode rays""",Physics,1862,1905,1892,1947,0,24,30,13
Joseph John Thomson,"""in recognition of the great merits of his theoretical and experimental investigations on the conduction of electricity by gases""",Physics,1856,1906,1897,1940,0,24,41,9
Albert Abraham Michelson,"""for his optical precision instruments and the spectroscopic and metrological investigations carried out with their aid""",Physics,1852,1907,1887,1931,0,21,35,20
Gabriel Lippmann,"""for his method of reproducing colours photographically based on the phenomenon of interference""",Physics,1845,1908,1891,1921,0,30,46,17
Karl Ferdinand Braun,"""in recognition of their contributions to the development of wireless telegraphy""",Physics,1850,1909,1899,1918,0,22,49,10
Guglielmo Marconi,"""in recognition of their contributions to the development of wireless telegraphy""",Physics,1874,1909,1896,1937,0,21,22,13
Johannes Diderik van der Waals,"""for his work on the equation of state for gases and liquids""",Physics,1837,1910,1880,1923,1,36,43,30
Wilhelm Wien,"""for his discoveries regarding the laws governing the radiation of heat""",Physics,1864,1911,1893,1928,1,22,29,18
Nils Gustaf Dalen,"""for his invention of automatic regulators for use in conjunction with gas accumulators for illuminating lighthouses and buoys""",Physics,1869,1912,1907,1937,0,27,38,5
Heike Kamerlingh Onnes,"""for his investigations on the properties of matter at low temperatures which led, inter alia, to the production of liquid helium""",Physics,1853,1913,1909,1926,0,26,56,4
Max von Laue,"""for his discovery of the diffraction of X-rays by crystals""",Physics,1879,1914,1912,1960,1,24,33,2
Sir William Henry Bragg,"""for their services in the analysis of crystal structure by means of X-rays""",Physics,1862,1915,1912,1971,0,22,50,3
William Lawrence Bragg,"""for their services in the analysis of crystal structure by means of X-rays""",Physics,1890,1915,1912,1942,0,22,22,3
Charles Glover Barkla,"""for his discovery of the characteristic Röntgen radiation of the elements""",Physics,1877,1917,1906,1944,0,27,29,11
Max Karl Ernst Ludwig Planck,"""in recognition of the services he rendered to the advancement of Physics by his discovery of energy quanta""",Physics,1858,1918,1900,1947,1,21,42,18
Johannes Stark,"""for his discovery of the Doppler effect in canal rays and the splitting of spectral lines in electric fields""",Physics,1874,1919,1905,1957,0,23,31,14
Charles Edouard Guillaume,"""in recognition of the service he has rendered to precision measurements in Physics by his discovery of anomalies in nickel steel alloys""",Physics,1861,1920,1897,1938,0,22,36,23
Albert Einstein,"""for his services to Theoretical Physics, and especially for his discovery of the law of the photoelectric effect""",Physics,1879,1921,1905,1955,1,26,26,16
Niels Henrik David Bohr,"""for his services in the investigation of the structure of atoms and of the radiation emanating from them""",Physics,1885,1922,1913,1962,1,26,28,9
Robert Andrews Millikan,"""for his work on the elementary charge of electricity and on the photoelectric effect""",Physics,1868,1923,1910,1953,0,27,42,13
Karl Manne Georg Siegbahn,"""for his discoveries and research in the field of X-ray spectroscopy""",Physics,1886,1924,1916,1978,0,25,30,8
James Franck,"""for their discovery of the laws governing the impact of an electron upon an atom""",Physics,1882,1925,1913,1964,0,24,31,12
Gustav Ludwig Hertz,"""for their discovery of the laws governing the impact of an electron upon an atom""",Physics,1887,1925,1913,1975,0,24,26,12
Jean Baptiste Perrin,"""for his work on the discontinuous structure of matter, and especially for his discovery of sedimentation equilibrium""",Physics,1870,1926,1909,1942,0,27,39,17
Arthur Holly Compton,"""for his discovery of the effect named after him""",Physics,1892,1927,1923,1962,0,24,31,4
Charles Thomson Rees Wilson,"""for his method of making the paths of electrically charged particles visible by condensation of vapour""",Physics,1869,1927,1911,1959,0,23,42,16
Owen Willans Richardson,"""for his work on the thermionic phenomenon and especially for the discovery of the law named after him""",Physics,1879,1928,1901,1959,1,25,22,27
Prince Louis-Victor Pierre Raymond de Broglie,"""for his discovery of the wave nature of electrons""",Physics,1892,1929,1924,1987,1,32,32,5
Sir Chandrasekhara Venkata Raman,"""for his work on the scattering of light and for the discovery of the effect named after him""",Physics,1888,1930,1928,1970,0,19,40,2
Werner Karl Heisenberg,"""for the creation of quantum mechanics, the application of which has, inter alia, led to the discovery of the allotropic forms of hydrogen""",Physics,1901,1932,1925,1976,1,22,24,7
Paul Adrien Maurice Dirac,"""for the discovery of new productive forms of atomic theory""",Physics,1902,1933,1928,1984,1,24,26,5
Erwin Schrodinger,"""for the discovery of new productive forms of atomic theory""",Physics,1887,1933,1926,1961,1,23,39,7
James Chadwick,"""for the discovery of the neutron""",Physics,1891,1935,1932,1974,0,22,41,3
Carl David Anderson,"""for his discovery of the positron""",Physics,1905,1936,1932,1991,0,25,27,4
Victor Franz Hess,"""for his discovery of cosmic radiation""",Physics,1883,1936,1912,1964,0,23,29,24
Clinton Joseph Davisson,"""for their experimental discovery of the diffraction of electrons by crystals""",Physics,1881,1937,1926,1958,0,30,45,11
George Paget Thomson,"""for their experimental discovery of the diffraction of electrons by crystals""",Physics,1892,1937,1927,1975,0,22,35,10
Enrico Fermi,"""for his demonstrations of the existence of new radioactive elements produced by neutron irradiation, and for his related discovery of nuclear reactions brought about by slow neutrons""",Physics,1901,1938,1934,1954,1,21,33,4
Ernest Orlando Lawrence,"""for the invention and development of the cyclotron and for results obtained with it, especially with regard to artificial radioactive elements""",Physics,1901,1939,1931,1958,0,24,30,8
Otto Stern,"""for his contribution to the development of the molecular ray method and his discovery of the magnetic moment of the proton""",Physics,1888,1943,1922,1969,0,24,34,21
Isidor Isaac Rabi,"""for his resonance method for recording the magnetic properties of atomic nuclei""",Physics,1898,1944,1937,1988,0,29,39,7
Wolfgang Pauli,"""for the discovery of the Exclusion Principle, also called the Pauli Principle""",Physics,1900,1945,1925,1958,1,21,25,20
Percy Williams Bridgman,"""for the invention of an apparatus to produce extremely high pressures, and for the discoveries he made therewith in the field of high pressure physics""",Physics,1882,1946,1909,1961,0,26,27,37
Sir Edward Victor Appleton,"""for his investigations of the physics of the upper atmosphere especially for the discovery of the so-called Appleton layer""",Physics,1892,1947,1926,1965,0,21,34,21
Patrick Maynard Stuart Blackett,"""for his development of the Wilson cloud chamber method, and his discoveries therewith in the fields of nuclear physics and cosmic radiation""",Physics,1897,1948,1934,1974,0,26,37,14
Hideki Yukawa,"""for his prediction of the existence of mesons on the basis of theoretical work on nuclear forces""",Physics,1907,1949,1934,1981,1,22,27,15
Cecil Frank Powell,"""for his development of the photographic method of studying nuclear processes and his discoveries regarding mesons made with this method""",Physics,1903,1950,1946,1969,0,24,43,4
Sir John Douglas Cockcroft,"""for their pioneer work on the transmutation of atomic nuclei by artificially accelerated atomic particles""",Physics,1897,1951,1932,1967,0,31,35,19
Ernest Thomas Sinton Walton,"""for their pioneer work on the transmutation of atomic nuclei by artificially accelerated atomic particles""",Physics,1903,1951,1932,1995,0,28,29,19
Felix Bloch,"""for their development of new methods for nuclear magnetic precision measurements and discoveries in connection therewith""",Physics,1905,1952,1946,1983,1,23,41,6
Edward Mills Purcell,"""for their development of new methods for nuclear magnetic precision measurements and discoveries in connection therewith""",Physics,1912,1952,1948,,0,26,36,4
Frits Zernike,"""for his demonstration of the phase contrast method, especially for his invention of the phase contrast microscope""",Physics,1888,1953,1934,1966,0,27,46,19
Max Born,"""for his fundamental research in quantum mechanics, especially for his statistical interpretation of the wavefunction""",Physics,1882,1954,1925,1970,1,25,43,29
Walther Bothe,"""for the coincidence method and his discoveries made therewith""",Physics,1891,1954,1924,1957,0,23,33,30
Polykarp Kusch,"""for his precision determination of the magnetic moment of the electron""",Physics,1911,1955,1947,1993,0,25,36,8
Willis E. Lamb,"""for his discoveries concerning the fine structure of the hydrogen spectrum""",Physics,1913,1955,1947,,0,25,34,8
John Bardeen,"""for their researches on semiconductors and their discovery of the transistor effect""",Physics,1908,1956,1947,1991,1,28,39,9
Walter Houser Brattain,"""for their researches on semiconductors and their discovery of the transistor effect""",Physics,1902,1956,1947,1987,0,27,45,9
William Bradford Shockley,"""for their researches on semiconductors and their discovery of the transistor effect""",Physics,1910,1956,1945,1989,0,26,35,11
Tsung-Dao (T.D.) Lee,"""for their penetrating investigation of the so-called parity laws which has led to important discoveries regarding the elementary particles""",Physics,1926,1957,1956,,1,24,30,1
Chen Ning Yang,"""for their penetrating investigation of the so-called parity laws which has led to important discoveries regarding the elementary particles""",Physics,1922,1957,1956,,1,26,34,1
Pavel Alekseyevich Cherenkov,"""for the discovery and the interpretation of the Cherenkov effect""",Physics,1904,1958,1934,,0,24,30,24
Ilja Mikhailovich Frank,"""for the discovery and the interpretation of the Cherenkov effect""",Physics,1908,1958,1937,1990,1,27,29,21
Igor Yevgenyevich Tamm,"""for the discovery and the interpretation of the Cherenkov effect""",Physics,1895,1958,1937,1971,1,38,42,21
Owen Chamberlain,"""for their discovery of the antiproton""",Physics,1920,1959,1955,,0,29,35,4
Emilio Gino Segre,"""for their discovery of the antiproton""",Physics,1905,1959,1955,1989,0,23,50,4
Donald Arthur Glaser,"""for the invention of the bubble chamber""",Physics,1926,1960,1952,,0,24,26,8
Robert Hofstadter,"""for his pioneering studies of electron scattering in atomic nuclei and for his thereby achieved discoveries concerning the structure of the nucleons""",Physics,1915,1961,1956,1990,0,23,41,5
Rudolf Ludwig Massbauer,"""for his researches concerning the resonance absorption of gamma radiation and his discovery in this connection of the effect which bears his name""",Physics,1929,1961,1958,,0,29,29,3
Lev Davidovich Landau,"""for his pioneering theories for condensed matter, especially liquid helium""",Physics,1908,1962,1937,1968,1,26,29,25
J. Hans D. Jensen,"""for their discoveries concerning nuclear shell structure""",Physics,1907,1963,1949,1973,1,25,42,14
Maria Goeppert Mayer,"""for their discoveries concerning nuclear shell structure""",Physics,1906,1963,1949,1972,1,24,43,14
Eugene Paul Wigner,"""for his contributions to the theory of the atomic nucleus and the elementary particles, particularly through the discovery and application of fundamental symmetry principles""",Physics,1902,1963,1933,1995,1,23,31,30
Nicolay Gennadiyevich Basov,"""for fundamental work in the field of quantum electronics, which has led to the construction of oscillators and amplifiers based on the maser-laser principle""",Physics,1922,1964,1954,2001,0,34,32,10
Aleksandr Mikhailovich Prokhorov,"""for fundamental work in the field of quantum electronics, which has led to the construction of oscillators and amplifiers based on the maser-laser principle""",Physics,1916,1964,1954,2002,0,30,38,10
Charles Hard Townes,"""for fundamental work in the field of quantum electronics, which has led to the construction of oscillators and amplifiers based on the maser-laser principle""",Physics,1915,1964,1954,,0,24,39,10
Richard P. Feynman,"""for their fundamental work in quantum electrodynamics, with deep-ploughing consequences for the physics of elementary particles""",Physics,1918,1965,1948,1988,1,24,30,17
Julian Schwinger,"""for their fundamental work in quantum electrodynamics, with deep-ploughing consequences for the physics of elementary particles""",Physics,1918,1965,1948,1994,1,21,30,17
Sin-Itiro Tomonaga,"""for their fundamental work in quantum electrodynamics, with deep-ploughing consequences for the physics of elementary particles""",Physics,1906,1965,1948,1979,1,33,42,17
Alfred Kastler,"""for the discovery and development of optical methods for studying Hertzian resonances in atoms""",Physics,1902,1966,1950,1984,0,34,48,16
Hans Albrecht Bethe,"""for his contributions to the theory of nuclear reactions, especially his discoveries concerning the energy production in stars""",Physics,1906,1967,1938,,1,22,32,29
Luis Walter Alvarez,"""for his decisive contributions to elementary particle physics, in particular the discovery of a large number of resonance states, made possible through his development of the technique of using hydrogen bubble chamber and data analysis""",Physics,1911,1968,1955,1988,0,25,44,13
Murray Gell-Mann,"""for his contributions and discoveries concerning the classification of elementary particles and their interactions""",Physics,1929,1969,1962,,1,22,33,7
Hannes Olof Gosta Alfven,"""for fundamental work and discoveries in magnetohydro-dynamics with fruitful applications in different parts of plasma physics""",Physics,1908,1970,1950,1995,1,26,42,20
Louis Eugene Felix Neel,"""for fundamental work and discoveries concerning antiferromagnetism and ferrimagnetism which have led to important applications in solid state physics""",Physics,1904,1970,1930,2000,1,28,26,40
Dennis Gabor,"""for his invention and development of the holographic method""",Physics,1900,1971,1947,1979,0,27,47,24
Leon Neil Cooper,"""for their jointly developed theory of superconductivity, usually called the BCS-theory""",Physics,1930,1972,1957,,1,24,27,15
John Robert Schrieffer,"""for their jointly developed theory of superconductivity, usually called the BCS-theory""",Physics,1931,1972,1957,,1,26,26,15
Leo Esaki,"""for their experimental discoveries regarding tunneling phenomena in semiconductors and superconductors""",Physics,1925,1973,1958,,0,34,33,15
Ivar Giaever,"""for their experimental discoveries regarding tunneling phenomena in semiconductors and superconductors""",Physics,1929,1973,1958,,0,23,29,15
Brian David Josephson,"""for his theoretical predictions of the properties of a supercurrent through a tunnel barrier, in particular those phenomena which are generally known as the Josephson effects""",Physics,1940,1973,1962,,1,24,22,11
Antony Hewish,"""for their pioneering research in radio astrophysics: Ryle for his observations and inventions, in particular of the aperture synthesis technique, and Hewish for his decisive role in the discovery of pulsars""",Physics,1924,1974,1967,,0,28,43,7
Sir Martin Ryle,"""for their pioneering research in radio astrophysics: Ryle for his observations and inventions, in particular of the aperture synthesis technique, and Hewish for his decisive role in the discovery of pulsars""",Physics,1918,1974,1962,1984,0,21,44,12
Aage Niels Bohr,"""for the discovery of the connection between collective motion and particle motion in atomic nuclei and the development of the theory of the structure of the atomic nucleus based on this connection""",Physics,1922,1975,1952,,1,24,30,23
Ben Roy Mottelson,"""for the discovery of the connection between collective motion and particle motion in atomic nuclei and the development of the theory of the structure of the atomic nucleus based on this connection""",Physics,1926,1975,1952,,1,24,26,23
Leo James Rainwater,"""for the discovery of the connection between collective motion and particle motion in atomic nuclei and the development of the theory of the structure of the atomic nucleus based on this connection""",Physics,1917,1975,1950,1986,1,29,33,25
Burton Richter,"""for their pioneering work in the discovery of a heavy elementary particle of a new kind""",Physics,1931,1976,1974,,0,25,43,2
Samuel Chao Chung Ting,"""for their pioneering work in the discovery of a heavy elementary particle of a new kind""",Physics,1936,1976,1974,,0,26,38,2
Sir Nevill Francis Mott,"""for their fundamental theoretical investigations of the electronic structure of magnetic and disordered systems""",Physics,1905,1977,1968,1996,1,25,63,9
John Hasbrouck van Vleck,"""for their fundamental theoretical investigations of the electronic structure of magnetic and disordered systems""",Physics,1899,1977,1932,1980,1,23,33,45
Pyotr Leonidovich Kapitsa,"""for his basic inventions and discoveries in the area of low-temperature physics""",Physics,1894,1978,1938,1984,0,29,44,40
Arno Allan Penzias,"""for their discovery of cosmic microwave background radiation""",Physics,1933,1978,1965,,0,29,32,13
Robert Woodrow Wilson,"""for their discovery of cosmic microwave background radiation""",Physics,1936,1978,1965,,0,26,29,13
Sheldon Lee Glashow,"""for their contributions to the theory of the unified weak and electromagnetic interaction between elementary particles, including, inter alia, the prediction of the weak neutral current""",Physics,1932,1979,1964,,1,27,32,15
Abdus Salam,"""for their contributions to the theory of the unified weak and electromagnetic interaction between elementary particles, including, inter alia, the prediction of the weak neutral current""",Physics,1926,1979,1968,1996,1,26,42,11
Steven Weinberg,"""for their contributions to the theory of the unified weak and electromagnetic interaction between elementary particles, including, inter alia, the prediction of the weak neutral current""",Physics,1933,1979,1967,,1,24,34,12
James Watson Cronin,"""for the discovery of violations of fundamental symmetry principles in the decay of neutral K-mesons""",Physics,1931,1980,1964,,0,24,33,16
Val Logsdon Fitch,"""for the discovery of violations of fundamental symmetry principles in the decay of neutral K-mesons""",Physics,1923,1980,1964,,0,31,41,16
Nicolaas Bloembergen,"""for their contribution to the development of laser spectroscopy""",Physics,1920,1981,1958,,0,28,38,23
Arthur Leonard Schawlow,"""for their contribution to the development of laser spectroscopy""",Physics,1921,1981,1958,1999,0,28,37,23
Kai M. Siegbahn,"""for his contribution to the development of high-resolution electron spectroscopy""",Physics,1918,1981,1957,,0,26,39,24
Kenneth G. Wilson,"""for his theory for critical phenomena in connection with phase transitions""",Physics,1936,1982,1971,,1,25,35,11
Subramanyan Chandrasekhar,"""for his theoretical studies of the physical processes of importance to the structure and evolution of the stars""",Physics,1910,1983,1935,1995,1,23,25,48
William Alfred Fowler,"""for his theoretical and experimental studies of the nuclear reactions of importance in the formation of the chemical elements in the universe""",Physics,1911,1983,1957,1995,1,25,46,26
Simon van der Meer,"""for their decisive contributions to the large project, which led to the discovery of the field particles W and Z, communicators of weak interaction""",Physics,1925,1984,1982,,0,27,57,2
Carlo Rubbia,"""for their decisive contributions to the large project, which led to the discovery of the field particles W and Z, communicators of weak interaction""",Physics,1934,1984,1982,,0,23,48,2
Klaus von Klitzing,"""for the discovery of the quantized Hall effect""",Physics,1943,1985,1980,,0,29,37,5
Gerd Binnig,"""for their design of the scanning tunneling microscope""",Physics,1947,1986,1981,,0,31,34,5
Heinrich Rohrer,"""for their design of the scanning tunneling microscope""",Physics,1933,1986,1981,,0,27,48,5
Ernst Ruska,"""for his fundamental work in electron optics, and for the design of the first electron microscope""",Physics,1906,1986,1933,1988,0,28,27,53
J. Georg Bednorz,"""for their important break-through in the discovery of superconductivity in ceramic materials""",Physics,1950,1987,1986,,0,32,36,1
K. Alexander Muller,"""for their important break-through in the discovery of superconductivity in ceramic materials""",Physics,1927,1987,1986,,0,31,59,1
Leon M. Lederman,"""for the neutrino beam method and the demonstration of the doublet structure of the leptons through the discovery of the muon neutrino""",Physics,1922,1988,1963,,0,29,41,25
Melvin Schwartz,"""for the neutrino beam method and the demonstration of the doublet structure of the leptons through the discovery of the muon neutrino""",Physics,1932,1988,1962,,0,26,30,26
Jack Steinberger,"""for the neutrino beam method and the demonstration of the doublet structure of the leptons through the discovery of the muon neutrino""",Physics,1921,1988,1962,,0,27,41,26
Hans G. Dehmelt,"""for the development of the ion trap technique""",Physics,1922,1989,1973,,0,28,51,16
Wolfgang Paul,"""for the development of the ion trap technique""",Physics,1913,1989,1958,1993,0,26,45,31
Norman F. Ramsey,"""for the invention of the separated oscillatory fields method and its use in the hydrogen maser and other atomic clocks""",Physics,1915,1989,1949,,0,25,34,40
Jerome I. Friedman,"""for their pioneering investigations concerning deep inelastic scattering of electrons on protons and bound neutrons, which have been of essential importance for the development of the quark model in particle physics""",Physics,1930,1990,1968,,0,26,38,22
Henry W. Kendall,"""for their pioneering investigations concerning deep inelastic scattering of electrons on protons and bound neutrons, which have been of essential importance for the development of the quark model in particle physics""",Physics,1926,1990,1968,,0,29,42,22
Richard E. Taylor,"""for their pioneering investigations concerning deep inelastic scattering of electrons on protons and bound neutrons, which have been of essential importance for the development of the quark model in particle physics""",Physics,1929,1990,1968,,0,33,39,22
Pierre-Gilles de Gennes,"""for discovering that methods developed for studying order phenomena in simple systems can be generalized to more complex forms of matter, in particular to liquid crystals and polymers""",Physics,1932,1991,1976,,0,23,44,15
Georges Charpak,"""for his invention and development of particle detectors, in particular the multiwire proportional chamber""",Physics,1924,1992,1968,,0,30,44,24
Russell A. Hulse,"""for the discovery of a new type of pulsar, a discovery that has opened up new possibilities for the study of gravitation""",Physics,1950,1993,1974,,0,25,24,19
Joseph H. Taylor Jr.,"""for the discovery of a new type of pulsar, a discovery that has opened up new possibilities for the study of gravitation""",Physics,1941,1993,1974,,0,27,33,19
Bertram N. Brockhouse,"""for the development of neutron spectroscopy""",Physics,1918,1994,1955,,0,32,37,39
Clifford G. Shull,"""for the development of the neutron diffraction technique""",Physics,1915,1994,1951,,0,26,36,43
Martin L. Perl,"""for the discovery of the tau lepton""",Physics,1927,1995,1974,,0,28,47,21
Frederick Reines,"""for the detection of the neutrino""",Physics,1918,1995,1953,,0,26,35,42
David M. Lee,"""for their discovery of superfluidity in helium-3""",Physics,1931,1996,1972,,0,28,41,24
Douglas D. Osheroff,"""for their discovery of superfluidity in helium-3""",Physics,1945,1996,1972,,0,28,27,24
Robert C. Richardson,"""for their discovery of superfluidity in helium-3""",Physics,1937,1996,1972,,0,29,35,24
Steven Chu,"""for development of methods to cool and trap atoms with laser light""",Physics,1948,1997,1985,,0,28,37,12
Claude Cohen-Tannoudji,"""for development of methods to cool and trap atoms with laser light""",Physics,1933,1997,1995,,0,29,62,2
William D. Phillips,"""for development of methods to cool and trap atoms with laser light""",Physics,1948,1997,1988,,0,28,40,9
Robert B. Laughlin,"""for their discovery of a new form of quantum fluid with fractionally charged excitations""",Physics,1950,1998,1983,,1,29,33,15
Horst L. Stormer,"""for their discovery of a new form of quantum fluid with fractionally charged excitations""",Physics,1949,1998,1982,,0,28,33,16
Daniel C. Tsui,"""for their discovery of a new form of quantum fluid with fractionally charged excitations""",Physics,1939,1998,1982,,0,28,43,16
Gerardus 't Hooft,"""for elucidating the quantum structure of electroweak interactions in physics""",Physics,1946,1999,1970,,1,26,24,29
Martinus J.G. Veltman,"""for elucidating the quantum structure of electroweak interactions in physics""",Physics,1931,1999,1970,,1,32,39,29
Zhores I. Alferov,"""for developing semiconductor heterostructures used in high-speed- and opto-electronics""",Physics,1930,2000,1966,,0,22,36,34
Jack S. Kilby,"""for his part in the invention of the integrated circuit""",Physics,1923,2000,1958,,0,35,35,42
Herbert Kroemer,"""for developing semiconductor heterostructures used in high-speed- and opto-electronics""",Physics,1928,2000,1960,,1,24,32,40
Eric A. Cornell,"""for the achievement of Bose-Einstein condensation in dilute gases of alkali atoms, and for early fundamental studies of the properties of the condensates""",Physics,1961,2001,1995,,0,29,34,6
Wolfgang Ketterle,"""for the achievement of Bose-Einstein condensation in dilute gases of alkali atoms, and for early fundamental studies of the properties of the condensates""",Physics,1957,2001,1995,,0,29,38,6
Carl E. Wieman,"""for the achievement of Bose-Einstein condensation in dilute gases of alkali atoms, and for early fundamental studies of the properties of the condensates""",Physics,1951,2001,1995,,0,26,44,6
Raymond Davis Jr.,"""for pioneering contributions to astrophysics, in particular for the detection of cosmic neutrinos""",Physics,1914,2002,1994,,0,28,80,8
Riccardo Giacconi,"""for pioneering contributions to astrophysics, which have led to the discovery of cosmic X-ray sources""",Physics,1931,2002,1969,,0,23,38,33
Masatoshi Koshiba,"""for pioneering contributions to astrophysics, in particular for the detection of cosmic neutrinos""",Physics,1926,2002,1987,,0,29,61,15
Alexei A. Abrikosov,"""for pioneering contributions to the theory of superconductors and superfluids""",Physics,1928,2003,1957,,1,23,29,46
Vitaly L. Ginzburg,"""for pioneering contributions to the theory of superconductors and superfluids""",Physics,1916,2003,1950,,1,26,34,53
Anthony J. Leggett,"""for pioneering contributions to the theory of superconductors and superfluids""",Physics,1938,2003,1972,,1,26,34,31
David J. Gross,"""for the discovery of asymptotic freedom in the theory of the strong interaction""",Physics,1941,2004,1973,,0,25,32,31
H. David Politzer,"""for the discovery of asymptotic freedom in the theory of the strong interaction""",Physics,1949,2004,1973,,0,25,24,31
Frank Wilczek,"""for the discovery of asymptotic freedom in the theory of the strong interaction""",Physics,1951,2004,1973,,0,23,22,31
Roy J. Glauber,"""for his contribution to the quantum theory of optical coherence""",Physics,1925,2005,1963,,0,24,38,42
John L. Hall,"""for their contributions to the development of laser-based precision spectroscopy, including the optical frequency comb technique""",Physics,1934,2005,2000,,0,27,66,5
Theodor W. Hansch,"""for their contributions to the development of laser-based precision spectroscopy, including the optical frequency comb technique""",Physics,1941,2005,1999,,0,28,58,6
John C. Mather,"""for their discovery of the blackbody form and anisotropy of the cosmic microwave background radiation""",Physics,1946,2006,1990,,0,28,44,16
George F. Smoot,"""for their discovery of the blackbody form and anisotropy of the cosmic microwave background radiation""",Physics,1945,2006,1992,,0,25,47,14
Albert Fert,"""for the discovery of Giant Magnetoresistance""",Physics,1938,2007,1988,,0,32,50,19
Peter Grunberg,"""for the discovery of Giant Magnetoresistance""",Physics,1939,2007,1988,,0,30,49,19
Makoto Kobayashi,"""for the discovery of the origin of the broken symmetry which predicts the existence of at least three families of quarks in nature""",Physics,1944,2008,1972,,0,28,28,36
Toshihide Maskawa,"""for the discovery of the origin of the broken symmetry which predicts the existence of at least three families of quarks in nature""",Physics,1940,2008,1972,,0,27,32,36
Yoichiro Nambu,"""for the discovery of the mechanism of spontaneous broken symmetry in subatomic physics""",Physics,1921,2008,1960,,0,31,39,48
